C 137,207,240
F 30,2,1

NO ./xpmfiles/wall.xpm
SO ./xpmfiles/mariio.xpm
EA ./xpmfiles/wall1.xpm
WE ./xpmfiles/wallbl2.xpm

111111111
1S0000001
110000001
110000001
100000001
110000001
100000001
110000001
100000001
110000001
100000001
111111111



