F 30,30,30
C 137,207,240

NO ./xpmfiles/wall.xpm
SO ./xpmfiles/mariio.xpm
EA ./xpmfiles/wallbl2.xpm
WE ./xpmfiles/wall1.xpm

111111111111111
1000001000001
1111111111111111