EA xpmfiles/wall.xpm
SO xpmfiles/wall.xpm

NO xpmfiles/wall1.xpm
WE xpmfiles/wall.xpm
F 30,30,30
C 30,30,30

11111111111111111111111111111111111111111
100000000000000000000000000001
100000000110000000000000000001
1000000010N0000000000000000001
100000000110000000000000000001
11111111111111111111111101111111111111111
10000000000000000000110000000000000000001
11111111111111111111111111111111111111111

