C 137,207,240
F 30,30,30

NO ./xpmfiles/wall.xpm
SO ./xpmfiles/wall.xpm
EA ./xpmfiles/wallbl2.xpm
WE ./xpmfiles/wallbl2.xpm

111111111111111
100000100000001
10000111111111111111111111
10000011000000000000010001
10000010000000000000000001
10000011000000000000010001
11101111111011111111110001
110000110000001      10001
100000010000001      10001
100000010000001      10001
10000000000000111111111011111111111
10000001000000100000000000000000001
100000010000001000000000W00000000011111
110000110000001001110000000000110010001
111111111111111001000001000000010010001
              1000000000000000000010001
              1000000000000000000010001
              1000000000000000000000001
              1000000000000000000010001
              1000000000000000000010001
              1001000000000000010010001
              1001100000000000110010001
              1000000000000000000010001
              1000000000000000000010001
              1111111111111111111110001
                                  10001
                               11110001111
                               10000000001
   1111111111111               10000000001
   1000000000001               10000000001
   1000000000001               10000000001
   1000000000001               10000000001
   1000000000001               10100000101
   1000000000001               10000000001
   10011111111111111111111     11111011111
   10000000000000000000001       100001
   11110000000000000000001       100001
      10000000000000000001       100001
  1111100000000000011101111111111100001
  1000000000000000010000000000000000001
  1000100000000000010000000000000000001
  1000100000000000010000000000000000001
  1000111111011111110000000000000000001
  1000000010001    11101111111111111111
  1000000000001    100000000001
  1000000010001    100000000001
  1111011110001    100000000001
    10001 10101    100000000001
    10001110111    100000000001
    10000000001    100000000001
    11111100001    111111011111
         110001        10001
          10001        10001
           10001       10101
            10001      11111
             10001
              10001
               10001
                10001111111111111111111111111111111111111
                10000010001000001000000010000000001010001
                11100010101011101011101110111011101011101
                10000000101010101000100000101010000000001
                10100010111110101111111010101110111111111
                10100010100000000010000010100010100010001
                10100011111111111010111110101111111010101
                10100010001000001010000010000010100000101
                10100010101110111011101011111110111111101
                10000010101000001000001010100010001000001
                10100010111111101110111110101111101011101
                10100000000010000010000000000010000000101
                11100010111110111010101011101110111111111
                10100010000000100000101000100000100000001
                10100010111010111010101111111110101111101
                10000000001010001010101000000010000010101
                10100011101110101011111011101110111010101
                10100010001010101000001000100010001010101
                10100010101011101111101011101111101010101
                10100010101000101000100000100010101010001
                10100010101110101110101011111110111011101
                10100010100000101000001000100010001010101
                10100010101111111110101111101110101010101
                10000000100010000000100010000010101010101
                10100011101010101111111110111110111010111
                10100010001010100000000000100000100010001
                10100011111011111111111110101111111111101
                10100000101000001000001000101000001000001
                11100010101111111010111110101010111011111
                10000000000010000010100010000010100000001
                10100011111011101010101111111110111111101
                10100000001000001010000010000010001010001
                11100010111110111011111010111111101010101
                10000010100000100000001010100000100010101
                10100010101011101111101110101110111010111
                10100000101010000010000010001000000010001
                10100011101010111011111111111010111010101
                10100000001010101000000000001000001010101
                1010000000000000101110111000101100110000011111111
                1010000000001000000000000010001000000010000000001
                1111111111111111111111111111111111111111111000001
                                                        100000001
                                                        100000001
                                                        100000001
                                                        100000001
                                                        111111111
                                                                

