C 137,207,240  
F 21,130,30

NO ./xpmfiles/wall1.xpm
SO ./xpmfiles/wallbl2.xpm
EA ./xpmfiles/mariio.xpm
WE ./xpmfiles/wall.xpm

1111111111111
1000000000001
1100000N00001
1100000000001
1100001000001
1100000000001
1100000000001
1100000000001
1100000000001
1100000000001
1100000000001
1100000000001
1100000000001
1100000000001
1100000000001
1100000000001
1100000000001
1100000000001
1100000000001
1100000000001
1100000000001
1100000000001
1100000000001
1100000000001
1100000000001
1100000000001
1100000000001
1100000000001
1100000000001
1100000000001
1100000000001
1100000000001
1100000000001
1100000000001
1100000000001
1100000000001
1100000000001
1100000000001
1100000000001
1100000000001
1100000000001
1100000000001
1100001000001
1100000000001
1100000000001
1100000000001
1100000000001
1100000000001
1100000000001
1100000000001
1100000000001
1100000000001
1100000000001
1100000000001
1100000000001
1100000000001
1100000000001
1100000000001
1100000000001
1100000000001
1100000000001
1100000000001
1100000000001
1100000000001
1100000000001
1100000000001
1100000000001
1100000000001
1100000000001
1100000000001
1100000000001
1100000000001
1100000000001
1100000000001
1100000000001
1100000000001
1100000000001
1100000000001
1100000000001
1100000000001
1100000000001
1100000000001
1100000000001
1100000000001
1100000000001
1100000000001
1100000000001
1100000000001
1100001000001
1100000000001
1100000000001
1100000000001
1100000000001
1100000000001
1100000000001
1100000000001
1100000000001
1100000000001
1100000000001
1100000000001
1100000000001
1100000000001
1100000000001
1100000000001
1100000000001
1100000000001
1100000000001
1100000000001
1100000000001
1100000000001
1100000000001
1100000000001
1100000000001
1100000000001
1100000000001
1100000000001
1100000000001
1100000000001
1100000000001
1100000000001
1100000000001
1100000000001
1100000000001
1100000000001
1100000000001
1100000000001
1100000000001
1100000000001
1100000000001
1100001000001
1100000000001
1100000000001
1100000000001
1100000000001
1000000000001
1111111111111




