C 137,207,240  
F 21,130,30


NO ./xpmfiles/wall1.xpm
SO ./xpmfiles/wallbl2.xpm
EA ./xpmfiles/mariio.xpm
WE ./xpmfiles/wall.xpm


11111111
1111111N11
1111111111111