C 137,207,240  
F 21,130,30


NO ./xpmfiles/wall1.xpm
SO ./xpmfiles/wallbl2.xpm
EA ./xpmfiles/mariio.xpm
WE ./xpmfiles/wall.xpm


1111111
111
11111N11
11111001
10000001
11111111
111111111